0 0 0
0 0 0 0
0.9412 0.9608 0.9569
216
 -259.2 -9.641 -130.2    -259.2 -9.641 150.8    -259.2 -8.285 -130.2
          -259.2 -8.285 150.8    215.6 -9.641 -130.2    215.6 -9.641 150.8
          215.6 -8.285 -130.2    215.6 -8.285 150.8    193.4 -8.299 -123.3
          193.4 -8.299 130.3    201.9 -8.299 -123.3    201.9 -8.299 130.3
          193.4 10.82 -123.3    193.4 10.82 130.3    201.9 10.82 -123.3
          201.9 10.82 130.3    -241.7 -8.299 85.73    173.4 -8.299 85.73   
          -241.7 -8.299 77.24    173.4 -8.299 77.24    -241.7 10.82 85.73
          173.4 10.82 85.73    -241.7 10.82 77.24    173.4 10.82 77.24    
          96.66 -8.299 128.5    202.3 -8.299 128.5    96.66 -8.299 120
          202.3 -8.299 120    96.66 10.82 128.5    202.3 10.82 128.5   
          96.66 10.82 120    202.3 10.82 120    162.9 -8.299 -97.71
          162.9 -8.299 54.93    171.4 -8.299 -97.71    171.4 -8.299 54.93
          162.9 10.82 -97.71    162.9 10.82 54.93    171.4 10.82 -97.71
          171.4 10.82 54.93    96.99 -8.299 80.78    96.99 -8.299 126.6   
          105.5 -8.299 80.78    105.5 -8.299 126.6    96.99 10.82 80.78
          96.99 10.82 126.6    105.5 10.82 80.78    105.5 10.82 126.6    
          35.57 -8.299 54.12    171.8 -8.299 54.12    35.57 -8.299 45.62    
          171.8 -8.299 45.62    35.57 10.82 54.12    171.8 10.82 54.12
          35.57 10.82 45.62    171.8 10.82 45.62    94.88 -8.299 -88.35    
          170.3 -8.299 -88.35    94.88 -8.299 -96.85    170.3 -8.299 -96.85
          94.88 10.82 -88.35    170.3 10.82 -88.35    94.88 10.82 -96.85
          170.3 10.82 -96.85    96.66 -8.299 -114.5    202.3 -8.299 -114.5
          96.66 -8.299 -123    202.3 -8.299 -123    96.66 10.82 -114.5
          202.3 10.82 -114.5    96.66 10.82 -123    202.3 10.82 -123
          -199.2 -8.299 -110.8    43.5 -8.299 -110.8    -199.2 -8.299 -119.3
          43.5 -8.299 -119.3    -199.2 10.82 -110.8    43.5 10.82 -110.8
          -199.2 10.82 -119.3    43.5 10.82 -119.3    35.12 -8.299 -119.3    
          35.12 -8.299 54.38    43.62 -8.299 -119.3    43.62 -8.299 54.38
          35.12 10.82 -119.3    35.12 10.82 54.38    43.62 10.82 -119.3    
          43.62 10.82 54.38    -102 -8.299 -12.93    43.84 -8.299 -12.93   
          -102 -8.299 -21.43    43.84 -8.299 -21.43    -102 10.82 -12.93
          43.84 10.82 -12.93    -102 10.82 -21.43    43.84 10.82 -21.43   
          -196.6 -8.299 -45.95    -2.207 -8.299 -45.95    -196.6 -8.299 -54.45    
          -2.207 -8.299 -54.45    -196.6 10.82 -45.95    -2.207 10.82 -45.95
          -196.6 10.82 -54.45    -2.207 10.82 -54.45    -60.45 -8.299 -78.34    
          -2.289 -8.299 -78.34    -60.45 -8.299 -86.84    -2.289 -8.299 -86.84    
          -60.45 10.82 -78.34    -2.289 10.82 -78.34    -60.45 10.82 -86.84
          -2.289 10.82 -86.84    -11.29 -8.299 -117.6    -11.29 -8.299 -79.62    
          -2.788 -8.299 -117.6    -2.788 -8.299 -79.62    -11.29 10.82 -117.6
          -11.29 10.82 -79.62    -2.788 10.82 -117.6    -2.788 10.82 -79.62
          -99.13 -8.299 -117.6    -99.13 -8.299 -79.62    -90.63 -8.299 -117.6   
          -90.63 -8.299 -79.62    -99.13 10.82 -117.6    -99.13 10.82 -79.62
          -90.63 10.82 -117.6    -90.63 10.82 -79.62    -150.8 -8.299 -78.34    
          -90.79 -8.299 -78.34    -150.8 -8.299 -86.84    -90.79 -8.299 -86.84
          -150.8 10.82 -78.34    -90.79 10.82 -78.34    -150.8 10.82 -86.84    
          -90.79 10.82 -86.84    -151.2 -8.299 -117.6    -151.2 -8.299 -79.62   
          -142.8 -8.299 -117.6    -142.8 -8.299 -79.62    -151.2 10.82 -117.6
          -151.2 10.82 -79.62    -142.8 10.82 -117.6    -142.8 10.82 -79.62    
          -238.8 -8.299 -78.34    -182.3 -8.299 -78.34    -238.8 -8.299 -86.84   
          -182.3 -8.299 -86.84    -238.8 10.82 -78.34    -182.3 10.82 -78.34
          -238.8 10.82 -86.84    -182.3 10.82 -86.84    -239.7 -8.299 -119.6
          -239.7 -8.299 83.52    -231.2 -8.299 -119.6    -231.2 -8.299 83.52
          -239.7 10.82 -119.6    -239.7 10.82 83.52    -231.2 10.82 -119.6
          -231.2 10.82 83.52    -152.2 -8.299 -50.81    -152.2 -8.299 14.72
          -143.7 -8.299 -50.81    -143.7 -8.299 14.72    -152.2 10.82 -50.81
          -152.2 10.82 14.72    -143.7 10.82 -50.81    -143.7 10.82 14.72
          -236.7 -8.299 -13.07    -188.1 -8.299 -13.07    -236.7 -8.299 -21.56    
          -188.1 -8.299 -21.56    -236.7 10.82 -13.07    -188.1 10.82 -13.07
          -236.7 10.82 -21.56    -188.1 10.82 -21.56    -196.3 -8.299 -19.66
          -196.3 -8.299 52.72    -187.8 -8.299 -19.66    -187.8 -8.299 52.72
          -196.3 10.82 -19.66    -196.3 10.82 52.72    -187.8 10.82 -19.66
          -187.8 10.82 52.72    -151.7 -8.299 19.82    -43.94 -8.299 19.82
          -151.7 -8.299 11.33    -43.94 -8.299 11.33    -151.7 10.82 19.82
          -43.94 10.82 19.82    -151.7 10.82 11.33    -43.94 10.82 11.33
          -13.55 -8.299 10.08    -13.55 -8.299 82.05    -5.053 -8.299 10.08
          -5.053 -8.299 82.05    -13.55 10.82 10.08    -13.55 10.82 82.05
          -5.053 10.82 10.08    -5.053 10.82 82.05    -52.22 -8.299 12.61
          -52.22 -8.299 52.92    -43.72 -8.299 12.61    -43.72 -8.299 52.92
          -52.22 10.82 12.61    -52.22 10.82 52.92    -43.72 10.82 12.61
          -43.72 10.82 52.92    -193 -8.299 52.6    -87.5 -8.299 52.6
          -193 -8.299 44.11    -87.5 -8.299 44.11    -193 10.82 52.6
          -87.5 10.82 52.6    -193 10.82 44.11    -87.5 10.82 44.11
324
          2    0    3        1    3    0        5    4    7        6    7    4        1    0    5
          4    5    0        3    1    7        5    7    1        2    3    6
          7    6    3        0    2    4        6    4    2        8    10    11
          11    9    8        12    13    15        15    14    12        8    9    13
          13    12    8        9    11    15        15    13    9        11    10    14
          14    15    11        10    8    12        12    14    10        16    18    19
          19    17    16        20    21    23        23    22    20        16    17    21
          21    20    16        17    19    23        23    21    17        19    18    22
          22    23    19        18    16    20        20    22    18        24    26    27       
          27    25    24        28    29    31        31    30    28        24    25    29
          29    28    24        25    27    31        31    29    25        27    26    30
          30    31    27        26    24    28        28    30    26        32    34    35
          35    33    32        36    37    39        39    38    36        32    33    37
          37    36    32        33    35    39        39    37    33        35    34    38
          38    39    35        34    32    36        36    38    34        40    42    43
          43    41    40        44    45    47        47    46    44        40    41    45
          45    44    40        41    43    47        47    45    41        43    42    46
          46    47    43        42    40    44        44    46    42        48    50    51
          51    49    48        52    53    55        55    54    52        48    49    53    
          53    52    48        49    51    55        55    53    49        51    50    54
          54    55    51        50    48    52        52    54    50        56    58    59       
          59    57    56        60    61    63        63    62    60        56    57    61
          61    60    56        57    59    63        63    61    57        59    58    62       
          62    63    59        58    56    60        60    62    58        64    66    67
          67    65    64        68    69    71        71    70    68        64    65    69
          69    68    64        65    67    71        71    69    65        67    66    70
          70    71    67        66    64    68        68    70    66        72    74    75
          75    73    72        76    77    79        79    78    76        72    73    77
          77    76    72        73    75    79        79    77    73        75    74    78
          78    79    75        74    72    76        76    78    74        80    82    83
          83    81    80        84    85    87        87    86    84        80    81    85
          85    84    80        81    83    87        87    85    81        83    82    86
          86    87    83        82    80    84        84    86    82        88    90    91
          91    89    88        92    93    95        95    94    92        88    89    93
          93    92    88        89    91    95        95    93    89        91    90    94
          94    95    91        90    88    92        92    94    90        96    98    99
          99    97    96        100    101    103        103    102    100    
          96    97    101        101    100    96        97    99    103       
          103    101    97        99    98    102        102    103    99       
          98    96    100        100    102    98        104    106    107
          107    105    104        108    109    111        111    110    108       
          104    105    109        109    108    104        105    107    111        
          111    109    105        107    106    110        110    111    107    
          106    104    108        108    110    106        112    114    115       
          115    113    112        116    117    119        119    118    116
          112    113    117        117    116    112        113    115    119        
          119    117    113        115    114    118        118    119    115       
          114    112    116        116    118    114        120    122    123        
          123    121    120        124    125    127        127    126    124    
          120    121    125        125    124    120        121    123    127
          127    125    121        123    122    126        126    127    123        
          122    120    124        124    126    122        128    130    131       
          131    129    128        132    133    135        135    134    132        
          128    129    133        133    132    128        129    131    135    
          135    133    129        131    130    134        134    135    131
          130    128    132        132    134    130        136    138    139       
          139    137    136        140    141    143        143    142    140       
          136    137    141        141    140    136        137    139    143    
          143    141    137        139    138    142        142    143    139       
          138    136    140        140    142    138        144    146    147
          147    145    144        148    149    151        151    150    148       
          144    145    149        149    148    144        145    147    151    
          151    149    145        147    146    150        150    151    147       
          146    144    148        148    150    146        152    154    155        
          155    153    152        156    157    159        159    158    156
          152    153    157        157    156    152        153    155    159        
          159    157    153        155    154    158        158    159    155       
          154    152    156        156    158    154        160    162    163    
          163    161    160        164    165    167        167    166    164       
          160    161    165        165    164    160        161    163    167
          167    165    161        163    162    166        166    167    163    
          162    160    164        164    166    162        168    170    171        
          171    169    168        172    173    175        175    174    172       
          168    169    173        173    172    168        169    171    175    
          175    173    169        171    170    174        174    175    171
          170    168    172        172    174    170        176    178    179    
          179    177    176        180    181    183        183    182    180       
          176    177    181        181    180    176        177    179    183    
          183    181    177        179    178    182        182    183    179    
          178    176    180        180    182    178        184    186    187
          187    185    184        188    189    191        191    190    188       
          184    185    189        189    188    184        185    187    191       
          191    189    185        187    186    190        190    191    187       
          186    184    188        188    190    186        192    194    195    
          195    193    192        196    197    199        199    198    196
          192    193    197        197    196    192        193    195    199    
          199    197    193        195    194    198        198    199    195    
          194    192    196        196    198    194        200    202    203    
          203    201    200        204    205    207        207    206    204    
          200    201    205        205    204    200        201    203    207
          207    205    201        203    202    206        206    207    203    
          202    200    204        204    206    202        208    210    211    
          211    209    208        212    213    215        215    214    212    
          208    209    213        213    212    208        209    211    215
          215    213    209        211    210    214        214    215    211
          210    208    212        212    214    210